                            
1111111111111111
14418  4 41ssss1
1341  4   1 4741
1 41    1914 4 1
1342    131 4 41
134144441114 4 1
1 42     1     1
1 41     1     1
1641     4  1  1
1541    34  16 1
1111111111111111

